##################################                                                          #####
##################################                                                          (****
##################################                                                               
##################################                                                               
##################################                                              <--->       [====
##################################                                                          #####
##################################                                                          #####
##################################                                       <--->              #####
##################################                                                          #####
####*****************************)                                                   [======#####
#### P                                                                               ############
####                                                           <--->       <--->     (******#####
####                                               <--->                                    #####
####                                                                                        #####
####                                                                                        #####
####                        [====]  <--->  <--->                                            #####
####                <--->   ######                [====]                                    #####
#### W     <----->          ######                ######    <--->                           #####
####===]                   J######                ######                                  D #####
########====================######                ######           <----->   <--->   [======#####
##################################                ######                             ############
##################################                ######                             ############