##################################                                                          #####
##################################                                                          #####
####*****************************)                                                          #####
#### P                                                                                      #####
####                                                                                        #####
####                                                                                        #####
####                                                                                        #####
####                                   D                                                    #####
####                        [====]   <--->                                                  #####
####                <--->   ######                                                          #####
#### W     <----->          ######                                                          #####
####===]                   J######                                                          #####
########====================######                                                          #####
##################################                                                          #####
##################################                                                          #####