#################################################################################################
#################################################################################################
####****************************************************************************************#####
#### P                                                                                      #####
####                                                                                        #####
####                                                                                        #####
####                                                                                        #####
####                                                                                        #####
####                        [====]                                                          #####
####                <--->   ######                                                          #####
####        <---->          ######                                                          #####
####===]                    ######                                                          #####
########====================######                                                          #####
##################################                                                          #####
##################################                                                          #####